%%%%%%%%%%%%%
S     % %   %
%%%%        %
%     %     %
%   % %%%%% %
%           %
%%  %%    % %
%           %
%   % %%% % %
%   %     % %
% % % % %%% %
% %         %
%%%%%%%%%%%%%
