%%%%%%%%%%%%%%%%%
S  %   %       %
%%%   % %   % % %
%               %
% %%% %%% %%% %%%
%       %   %   %
%%% %%% %%% %%% %
%       %   %   %
% %%% %%% %%% %%%
%   %       %   %
%%% %%% %%% %%% %
%   %   %       %
% %%% %%%   % %%%
%   %   %       %
%%% % % % % % % %
%   %   %       %
%%%%%%%%%%%%%%%%%