%S%%%%%%%%%%%
%           %
%%%%     %% %
%           %
% %%    %%%%%
%           %
%%%% %  %%% %
%           %
% %%%%    %%%
%           %
%%%    %%%% %
%           %
%%%%%%%%%%%%%