%%%%%%%S%%%%%
%           %
% %   %%%%% %
% %       % %
% %   %%% % %
% % %   % % %
% % %%%%% % %
% %       % %
%   %%%%%%% %
%           %
%     %%%%% %
%           %
%%%%%%%%%%%%%