%S%%%%%%%%%%%%%%%
%               %
% %%%%%%%%%%%%% %
% %           % %
% % %%%%%%%%% % %
% % %       % % %
% % % %%%%% % % %
% % % %   % % % %
% % % % % % % % %
% % % % %   % % %
% % % % %%%%% % %
% % % %       % %
% % % %%%%%%%%% %
% % %           %
% % %%%%%%%%%%% %
%               %
%%%%%%%%%%%%%%%%%