%%%%%%%%%S%%%%%%%%%%%
%                   %
% % %%%%%%%%%%%%%%% %
% %               % %
% % % %%%%%%%%%%% % %
% % %           % % %
% % % % %%%%%%% % % %
% % % %       % % % %
% % % % % %%% % % % %
% % % % %   % % % % %
% % % % %   % % % % %
% % % % %%%%% % % % %
% % % %       % % % %
% % % %%%%%%%%% % % %
% % %           % % %
% % %%%%%%%%%%%%% % %
% %               % %
% %%%%%%%%%%%%%%%%% %
% %                 %
%                   %
%%%%%%%%%%%%%%%%%%%%%