%%%%%%%%%%%%%%%%%%%%%
S                   %
% %%%%  %%%%%%%%%%% %
%                 % %
% %%%%  %%%%%%%%% % %
%                 % %
% %%%%  %%%%%%%%% % %
%                 % %
% %%%%  %%%%%%%%% % %
%                 % %
% %%%%  %%%%%%%%% % %
%                 % %
% %%%%  %%%%%%%%% % %
%                 % %
% %%%%  %%%%%%%%% % %
%                 % %
% %%%%  %%%%%%%%% % %
%                 % %
% %%%%  %%%%%%%%% % %
%                   %
%%%%%%%%%%%%%%%%%%%%%