%%%%%%%%%S%%%%%%%%%%%
%               %   %
% % % %%%%%%%%% % % %
% % % %       % % % %
% % % % %%%%% % % % %
% % % % %   % % % % %
% % % % %   % % % % %
% % % % %%%%% % % % %
% % % %       % % % %
% % % %%%%%%%%% % % %
% % %           % % %
% % %%%%%%%%%%% % % %
% %             % % %
% %%%%%%%%%%%%%%% % %
%                 % %
% %%%%%%%%%%%%%%%%% %
%                   %
% %%%%%%%%%%%%%%%%% %
%                   %
%                   %
%%%%%%%%%%%%%%%%%%%%%