%%%%%%%S%%%%%
%           %
% %  %%%%%% %
% %       % %
% % %%%%% % %
% % %   % % %
% % %%%%% % %
% %       % %
% %  %%%  % %
%           %
% %%%%%%%%% %
%           %
%%%%%%%%%%%%%