%%%%%%%%%S%%%%%%%
%       %       %
% %%%%% % %%%%% %
% %   % % %   % %
% % % % % % % % %
% % % %   % % % %
% % % %%%%% % % %
% % %       % % %
% % %%%%%%%%% % %
% %           % %
% %%%%%%%%%%% % %
%             % %
% %%%%%%%%%%%%% %
%               %
% %%%%%%%%%%%%% %
%               %
%%%%%%%%%%%%%%%%%